****************************************************
****      *************************              * *
*********  *                 *       ***  ****   * *
*          * *******  ****** * *******    ****     *
* * ****** * ***         *** *       ***  ****     *
* * **   * * *** *** *** *** ******* ***  ****   * *
* * ** * * * *** *** *** *** *       ***  ******** *
* * ** * * * *** *** *** *** * *********   *       *
*      * *       *** ***            ****** *  ***  *
* **** * * ********* ********** ********** *  ***  *                   
* **** *                                   *  ***  *
* **** ********* *********** *** * * ** ** *  ***  *
*             ** *****   *** *** * * ** **         *
****** * ******* ***** ***** *** * *    ** ******* *
****** * *                   *** * * ** ** ****    *
*      * * ******* ********* *** * * ** ** **** ** *
****** * *         *********     *   ** **         *
***        ******* ********* ******* **     ****** *
****************************************************
